  %v%
  %V%
  %V%%%%%%%%%%%%%%%%
  %V%V<<<<<<<<<<<<<%
  %V%V%%%%%%%%%%%%^%
  %V%V%V<<<<<<<<<%^%
  %V%V%V%%%%%%%%^%^%
  %V%V%>>>>>>E %^%^%
  %V%V%%%%%%%%%%^%^%
  %V%>>>>>>>>>>>^%^%
  %V%%%%%%%%%%%%%%^%
  %>>>>>>>>>>>>>>>^%
  %%%%%%%%%%%%%%%%%% 
