

%%%%%%%%%%%%%%%%%%
.>>>>>>>>>>>>>>>V%%%
%%%%%%%%%%%%%%%%>>V%
         %V<<<<%%%V%
   %%%%%%%V%%%^<<<<%
   %V<<<<<<%%%%%%%%%
   %V%%%%%%%%%%%%%%%%%
   %>>>>>>>>>>>>>>>>>E
   %%%%%%%%%%%%%%%%%%%